1 1 1 1 1 -1
1 1 1 1 1 -1
1 1 1 1 1 -1
1 1 1 1 1 -1
1 1 1 1 1
-2
6 6 6 6 6 6 6 6 6 6 6 6 6 6 6 -1
6 6 6 6 6 6 6 6 6 6 6 6 6 6 6 -1
6 6 6 6 6 6 6 6 6 6 6 6 6 6 6 -1
6 6 6 6 6 6 6 6 6 6 6 6 6 6 6 -1
6 6 6 6 6 6 6 6 6 6 6 6 6 6 6 -1
6 6 6 6 6 6 6 6 6 6 6 6 6 6 6 -1
6 6 6 6 6 6 6 6 6 6 6 6 6 6 6 -1
6 6 6 6 6 6 6 6 6 6 6 6 6 6 6 -1
6 6 6 6 6 6 6 6 6 6 6 6 6 6 6 -1
6 6 6 6 6 6 6 6 6 6 6 6 6 6 6 -1
6 6 6 6 6 6 6 6 6 6 6 6 6 6 6 -1
6 6 6 6 6 6 6 6 6 6 6 6 6 6 6 -1
6 6 6 6 6 6 6 6 6 6 6 6 6 6 6 -1
6 6 6 6 6 6 6 6 6 6 6 6 6 6 6
-2
6 6 6 6 6 6 6 6 6 6 6 6 6 6 6 -1
6 6 6 6 6 6 6 6 6 6 6 6 6 6 6 -1
6 6 6 6 6 6 6 6 6 6 6 6 6 6 6 -1
6 6 6 6 6 6 6 6 6 6 6 6 6 6 6 -1
6 6 6 6 6 6 6 6 6 6 6 6 6 6 6 -1
6 6 6 6 6 6 6 6 6 6 6 6 6 6 6 -1
6 6 6 6 6 6 6 6 6 6 6 6 6 6 6 -1
6 6 6 6 6 6 6 6 6 6 6 6 6 6 6 -1
6 6 6 6 6 6 6 6 6 6 6 6 6 6 6 -1
6 6 6 6 6 6 6 6 6 6 6 6 6 6 6 -1
6 6 6 6 6 6 6 6 6 6 6 6 6 6 6 -1
6 6 6 6 6 6 6 6 6 6 6 6 6 6 6 -1
6 6 6 6 6 6 6 6 6 6 6 6 6 6 6 -1
6 6 6 6 6 6 6 6 6 6 6 6 6 6 6
-2
6 6 6 6 6 6 6 6 6 6 6 6 6 6 6 6 6 6 6 6 6 -1
6 6 6 6 6 6 6 6 6 6 6 6 6 6 6 6 6 6 6 6 6 -1
6 6 6 6 6 6 6 6 6 6 6 6 6 6 6 6 6 6 6 6 6 -1
6 6 6 6 6 6 6 6 6 6 6 6 6 6 6 6 6 6 6 6 6 -1
6 6 6 6 6 6 6 6 6 6 5 6 6 6 6 6 6 6 6 6 6 -1
6 6 6 6 6 5 5 5 5 5 5 5 5 5 5 5 6 6 6 6 6 -1
6 6 6 6 6 5 5 5 5 5 5 5 5 5 5 5 6 6 6 6 6 -1
6 6 6 6 6 5 5 5 5 5 5 5 5 5 5 5 6 6 6 6 6 -1
6 6 6 6 6 5 5 5 5 5 5 5 5 5 5 5 6 6 6 6 6 -1
6 6 6 6 6 5 5 5 5 5 5 5 5 5 5 5 6 6 6 6 6 -1
6 6 6 6 6 5 5 5 5 5 5 5 5 5 5 5 6 6 6 6 6 -1
6 6 6 6 6 5 5 5 5 5 5 5 5 5 5 5 6 6 6 6 6 -1
6 6 6 6 6 5 5 5 5 5 5 5 5 5 5 5 6 6 6 6 6 -1
6 6 6 6 6 5 5 5 5 5 5 5 5 5 5 5 6 6 6 6 6 -1
6 6 6 6 6 5 5 5 5 5 5 5 5 5 5 5 6 6 6 6 6 -1
6 6 6 6 6 5 5 5 5 5 5 5 5 5 5 5 6 6 6 6 6 -1
6 6 6 6 6 6 6 6 6 3 3 3 6 6 6 6 6 6 6 6 6 -1
6 6 6 6 6 6 6 6 6 6 3 6 6 6 6 6 6 6 6 6 6 -1
6 6 6 6 6 6 6 6 6 6 6 6 6 6 6 6 6 6 6 6 6 -1
6 6 6 6 6 6 6 6 6 6 6 6 6 6 6 6 6 6 6 6 6 -1
6 6 6 6 6 6 6 6 6 6 6 6 6 6 6 6 6 6 6 6 6
-2
0 0 0 0 0 0 0 0 0 0 0 0 0 0 0 0 0 0 0 0 0 -1
0 0 0 0 0 0 0 0 0 0 0 0 0 0 0 0 0 0 0 0 0 -1
0 0 0 0 0 0 0 0 0 0 0 0 0 0 0 0 0 0 0 0 0 -1
0 0 0 0 0 0 0 0 0 0 0 0 0 0 0 0 0 0 0 0 0 -1
0 0 0 0 4 5 5 5 5 5 0 5 5 5 5 5 4 0 0 0 0 -1
0 0 0 0 5 0 0 0 0 0 0 0 0 0 0 0 5 0 0 0 0 -1
0 0 0 0 5 0 0 0 0 0 0 0 0 0 0 0 5 0 0 0 0 -1
0 0 0 0 5 0 0 0 0 0 0 0 0 0 0 0 5 0 0 0 0 -1
0 0 0 0 5 0 0 0 0 0 0 0 0 0 0 0 5 0 0 0 0 -1
0 0 0 0 5 0 0 0 0 0 0 0 0 0 0 0 5 0 0 0 0 -1
0 0 0 0 5 0 0 0 0 0 0 0 0 0 0 0 5 0 0 0 0 -1
0 0 0 0 5 0 0 0 0 0 0 0 0 0 0 0 5 0 0 0 0 -1
0 0 0 0 5 0 0 0 0 0 0 0 0 0 0 0 5 0 0 0 0 -1
0 0 0 0 5 0 0 0 0 0 0 0 0 0 0 0 5 0 0 0 0 -1
0 0 0 0 5 0 0 0 0 0 0 0 0 0 0 0 5 0 0 0 0 -1
0 0 0 0 5 0 0 0 0 0 0 0 0 0 0 0 5 0 0 0 0 -1
0 0 0 0 4 5 5 5 3 7 0 7 3 5 5 5 4 0 0 0 0 -1
0 0 0 0 0 0 0 0 3 3 7 3 3 0 0 0 0 0 0 0 0 -1
0 0 0 0 0 0 0 0 0 0 3 0 0 0 0 0 0 0 0 0 0 -1
0 0 0 0 0 0 0 0 0 0 0 0 0 0 0 0 0 0 0 0 0 -1
0 0 0 0 0 0 0 0 0 0 0 0 0 0 0 0 0 0 0 0 0
-2
0 0 0 0 0 0 0 0 0 0 0 0 0 0 0 0 0 0 0 0 0 -1
0 0 0 0 0 0 0 0 0 0 0 0 0 0 0 0 0 0 0 0 0 -1
0 0 0 0 0 0 0 0 0 0 0 0 0 0 0 0 0 0 0 0 0 -1
0 0 0 0 0 0 0 0 0 0 0 0 0 0 0 0 0 0 0 0 0 -1
0 0 0 0 4 5 5 1 1 5 0 5 1 1 5 5 4 0 0 0 0 -1
0 0 0 0 5 0 0 0 0 0 0 0 0 0 0 0 5 0 0 0 0 -1
0 0 0 0 5 0 0 0 0 0 0 0 0 0 0 0 5 0 0 0 0 -1
0 0 0 0 5 0 0 0 0 0 0 0 0 0 0 0 1 0 0 0 0 -1
0 0 0 0 5 0 0 0 0 0 0 0 0 0 0 0 1 0 0 0 0 -1
0 0 0 0 5 0 0 0 0 0 0 0 0 0 0 0 1 0 0 0 0 -1
0 0 0 0 5 0 0 0 0 0 0 0 0 0 0 0 5 0 0 0 0 -1
0 0 0 0 5 0 0 0 0 0 0 0 0 0 0 0 1 0 0 0 0 -1
0 0 0 0 5 0 0 0 0 0 0 0 0 0 0 0 1 0 0 0 0 -1
0 0 0 0 5 0 0 0 0 0 0 0 0 0 0 0 1 0 0 0 0 -1
0 0 0 0 5 0 0 0 0 0 0 0 0 0 0 0 5 0 0 0 0 -1
0 0 0 0 5 0 0 0 0 0 0 0 0 0 0 0 5 0 0 0 0 -1
0 0 0 0 4 5 5 5 3 0 0 0 3 5 5 5 4 0 0 0 0 -1
0 0 0 0 0 0 0 0 3 3 0 3 3 0 0 0 0 0 0 0 0 -1
0 0 0 0 0 0 0 0 0 0 3 0 0 0 0 0 0 0 0 0 0 -1
0 0 0 0 0 0 0 0 0 0 0 0 0 0 0 0 0 0 0 0 0 -1
0 0 0 0 0 0 0 0 0 0 0 0 0 0 0 0 0 0 0 0 0
-2
0 0 0 0 0 0 0 0 0 0 0 0 0 0 0 0 0 0 0 0 0 -1
0 0 0 0 0 0 0 0 0 0 0 0 0 0 0 0 0 0 0 0 0 -1
0 0 0 0 0 0 0 0 0 0 0 0 0 0 0 0 0 0 0 0 0 -1
0 0 0 0 0 0 0 0 0 0 0 0 0 0 0 0 0 0 0 0 0 -1
0 0 0 0 4 5 5 1 1 5 5 5 1 1 5 5 4 0 0 0 0 -1
0 0 0 0 5 0 0 0 0 0 0 0 0 0 0 0 5 0 0 0 0 -1
0 0 0 0 5 0 0 0 0 0 0 0 0 0 0 0 5 0 0 0 0 -1
0 0 0 0 5 0 0 0 0 0 0 0 0 0 0 0 1 0 0 0 0 -1
0 0 0 0 5 0 0 0 0 0 0 0 0 0 0 0 1 0 0 0 0 -1
0 0 0 0 5 0 0 0 0 0 0 0 0 0 0 0 1 0 0 0 0 -1
0 0 0 0 5 0 0 0 0 0 0 0 0 0 0 0 5 0 0 0 0 -1
0 0 0 0 5 0 0 0 0 0 0 0 0 0 0 0 1 0 0 0 0 -1
0 0 0 0 5 0 0 0 0 0 0 0 0 0 0 0 1 0 0 0 0 -1
0 0 0 0 5 0 0 0 0 0 0 0 0 0 0 0 1 0 0 0 0 -1
0 0 0 0 5 0 0 0 0 0 0 0 0 0 0 0 5 0 0 0 0 -1
0 0 0 0 5 0 0 0 0 0 0 0 0 0 0 0 5 0 0 0 0 -1
0 0 0 0 4 5 5 5 3 0 0 0 3 5 5 5 4 0 0 0 0 -1
0 0 0 0 0 0 0 0 3 3 0 3 3 0 0 0 0 0 0 0 0 -1
0 0 0 0 0 0 0 0 0 0 3 0 0 0 0 0 0 0 0 0 0 -1
0 0 0 0 0 0 0 0 0 0 0 0 0 0 0 0 0 0 0 0 0 -1
0 0 0 0 0 0 0 0 0 0 0 0 0 0 0 0 0 0 0 0 0
-2
0 0 0 0 0 0 0 0 0 0 0 0 0 0 0 0 0 0 0 0 0 -1
0 0 0 0 0 0 0 0 0 0 0 0 0 0 0 0 0 0 0 0 0 -1
0 0 0 0 0 0 0 0 0 0 0 0 0 0 0 0 0 0 0 0 0 -1
0 0 0 0 0 0 0 0 0 0 0 0 0 0 0 0 0 0 0 0 0 -1
0 0 0 0 4 5 5 5 5 5 5 5 5 5 5 5 4 0 0 0 0 -1
0 0 0 0 5 0 0 0 0 0 0 0 0 0 0 0 5 0 0 0 0 -1
0 0 0 0 5 0 0 0 0 0 0 0 0 0 0 0 5 0 0 0 0 -1
0 0 0 0 5 0 0 0 0 0 0 0 0 0 0 0 5 0 0 0 0 -1
0 0 0 0 5 0 0 0 0 0 0 0 0 0 0 0 5 0 0 0 0 -1
0 0 0 0 5 0 0 0 0 0 0 0 0 0 0 0 5 0 0 0 0 -1
0 0 0 0 5 0 0 0 0 0 0 0 0 0 0 0 5 0 0 0 0 -1
0 0 0 0 5 0 0 0 0 0 0 0 0 0 0 0 5 0 0 0 0 -1
0 0 0 0 5 0 0 0 0 0 0 0 0 0 0 0 5 0 0 0 0 -1
0 0 0 0 5 0 0 0 0 0 0 0 0 0 0 0 5 0 0 0 0 -1
0 0 0 0 5 0 0 0 0 0 0 0 0 0 0 0 5 0 0 0 0 -1
0 0 0 0 5 0 0 0 0 0 0 0 0 0 0 0 5 0 0 0 0 -1
0 0 0 0 4 5 5 5 5 5 5 5 5 5 5 5 4 0 0 0 0 -1
0 0 0 0 0 0 0 0 0 0 0 0 0 0 0 0 0 0 0 0 0 -1
0 0 0 0 0 0 0 0 0 0 0 0 0 0 0 0 0 0 0 0 0 -1
0 0 0 0 0 0 0 0 0 0 0 0 0 0 0 0 0 0 0 0 0 -1
0 0 0 0 0 0 0 0 0 0 0 0 0 0 0 0 0 0 0 0 0
-2
0 0 0 0 0 0 0 0 0 0 0 0 0 0 0 0 0 0 0 0 0 -1
0 0 0 0 0 0 0 0 0 0 0 0 0 0 0 0 0 0 0 0 0 -1
0 0 0 0 0 0 0 0 0 0 0 0 0 0 0 0 0 0 0 0 0 -1
0 0 0 0 0 0 0 0 0 0 0 0 0 0 0 0 0 0 0 0 0 -1
0 0 0 0 4 4 4 4 4 4 4 4 4 4 4 4 4 0 0 0 0 -1
0 0 0 0 4 0 0 0 0 0 0 0 0 0 0 0 4 0 0 0 0 -1
0 0 0 0 4 0 0 0 0 0 0 0 0 0 0 0 4 0 0 0 0 -1
0 0 0 0 4 0 0 0 0 0 0 0 0 0 0 0 4 0 0 0 0 -1
0 0 0 0 4 0 0 0 0 0 0 0 0 0 0 0 4 0 0 0 0 -1
0 0 0 0 4 0 0 0 0 0 0 0 0 0 0 0 4 0 0 0 0 -1
0 0 0 0 4 0 0 0 0 0 0 0 0 0 0 0 4 0 0 0 0 -1
0 0 0 0 4 0 0 0 0 0 0 0 0 0 0 0 4 0 0 0 0 -1
0 0 0 0 4 0 0 0 0 0 0 0 0 0 0 0 4 0 0 0 0 -1
0 0 0 0 4 0 0 0 0 0 0 0 0 0 0 0 4 0 0 0 0 -1
0 0 0 0 4 0 0 0 0 0 0 0 0 0 0 0 4 0 0 0 0 -1
0 0 0 0 4 0 0 0 0 0 0 0 0 0 0 0 4 0 0 0 0 -1
0 0 0 0 4 4 4 4 4 4 4 4 4 4 4 4 4 0 0 0 0 -1
0 0 0 0 0 0 0 0 0 0 0 0 0 0 0 0 0 0 0 0 0 -1
0 0 0 0 0 0 0 0 0 0 0 0 0 0 0 0 0 0 0 0 0 -1
0 0 0 0 0 0 0 0 0 0 0 0 0 0 0 0 0 0 0 0 0 -1
0 0 0 0 0 0 0 0 0 0 0 0 0 0 0 0 0 0 0 0 0
-2
0 0 0 0 0 0 0 0 0 0 0 0 0 0 0 0 0 0 0 0 0 -1
0 0 0 0 0 0 0 0 0 0 0 0 0 0 0 0 0 0 0 0 0 -1
0 0 0 0 0 0 0 0 0 0 0 0 0 0 0 0 0 0 0 0 0 -1
0 0 0 0 0 0 0 0 0 0 0 0 0 0 0 0 0 0 0 0 0 -1
0 0 0 0 0 0 0 0 0 0 0 0 0 0 0 0 0 0 0 0 0 -1
0 0 0 0 0 4 5 5 5 5 5 5 5 5 5 4 0 0 0 0 0 -1
0 0 0 0 0 4 0 0 0 0 0 0 0 0 0 4 0 0 0 0 0 -1
0 0 0 0 0 4 0 0 0 0 0 0 0 0 0 4 0 0 0 0 0 -1
0 0 0 0 0 4 0 0 0 0 0 0 0 0 0 4 0 0 0 0 0 -1
0 0 0 0 0 4 0 0 0 0 0 0 0 0 0 4 0 0 0 0 0 -1
0 0 0 0 0 4 0 0 0 0 0 0 0 0 0 4 0 0 0 0 0 -1
0 0 0 0 0 4 0 0 0 0 0 0 0 0 0 4 0 0 0 0 0 -1
0 0 0 0 0 4 0 0 0 0 0 0 0 0 0 4 0 0 0 0 0 -1
0 0 0 0 0 4 0 0 0 0 0 0 0 0 0 4 0 0 0 0 0 -1
0 0 0 0 0 4 0 0 0 0 0 0 0 0 0 4 0 0 0 0 0 -1
0 0 0 0 0 4 5 5 5 5 5 5 5 5 5 4 0 0 0 0 0 -1
0 0 0 0 0 0 0 0 0 0 0 0 0 0 0 0 0 0 0 0 0 -1
0 0 0 0 0 0 0 0 0 0 0 0 0 0 0 0 0 0 0 0 0 -1
0 0 0 0 0 0 0 0 0 0 0 0 0 0 0 0 0 0 0 0 0 -1
0 0 0 0 0 0 0 0 0 0 0 0 0 0 0 0 0 0 0 0 0 -1
0 0 0 0 0 0 0 0 0 0 0 0 0 0 0 0 0 0 0 0 0
-2
0 0 0 0 0 0 0 0 0 0 0 0 0 0 0 0 0 0 0 0 0 -1
0 0 0 0 0 0 0 0 0 0 0 0 0 0 0 0 0 0 0 0 0 -1
0 0 0 0 0 0 0 0 0 0 0 0 0 0 0 0 0 0 0 0 0 -1
0 0 0 0 0 0 0 0 0 0 0 0 0 0 0 0 0 0 0 0 0 -1
0 0 0 0 0 0 0 0 0 0 0 0 0 0 0 0 0 0 0 0 0 -1
0 0 0 0 0 0 4 5 5 5 5 5 5 5 4 0 0 0 0 0 0 -1
0 0 0 0 0 0 4 0 0 0 0 0 0 0 4 0 0 0 0 0 0 -1
0 0 0 0 0 0 4 0 0 0 0 0 0 0 4 0 0 0 0 0 0 -1
0 0 0 0 0 0 4 0 0 0 0 0 0 0 4 0 0 0 0 0 0 -1
0 0 0 0 0 0 4 0 0 0 0 0 0 0 4 0 0 0 0 0 0 -1
0 0 0 0 0 0 4 0 0 0 0 0 0 0 4 0 0 0 0 0 0 -1
0 0 0 0 0 0 4 0 0 0 0 0 0 0 4 0 0 0 0 0 0 -1
0 0 0 0 0 0 4 0 0 0 0 0 0 0 4 0 0 0 0 0 0 -1
0 0 0 0 0 0 4 0 0 0 0 0 0 0 4 0 0 0 0 0 0 -1
0 0 0 0 0 0 4 0 0 0 0 0 0 0 4 0 0 0 0 0 0 -1
0 0 0 0 0 0 4 5 5 5 5 5 5 5 4 0 0 0 0 0 0 -1
0 0 0 0 0 0 0 0 0 0 0 0 0 0 0 0 0 0 0 0 0 -1
0 0 0 0 0 0 0 0 0 0 0 0 0 0 0 0 0 0 0 0 0 -1
0 0 0 0 0 0 0 0 0 0 0 0 0 0 0 0 0 0 0 0 0 -1
0 0 0 0 0 0 0 0 0 0 0 0 0 0 0 0 0 0 0 0 0 -1
0 0 0 0 0 0 0 0 0 0 0 0 0 0 0 0 0 0 0 0 0
-2
0 0 0 0 0 0 0 0 0 0 0 0 0 0 0 0 0 0 0 0 0 -1
0 0 0 0 0 0 0 0 0 0 0 0 0 0 0 0 0 0 0 0 0 -1
0 0 0 0 0 0 0 0 0 0 0 0 0 0 0 0 0 0 0 0 0 -1
0 0 0 0 0 0 0 0 0 0 0 0 0 0 0 0 0 0 0 0 0 -1
0 0 0 0 0 0 0 0 0 0 0 0 0 0 0 0 0 0 0 0 0 -1
0 0 0 0 0 0 0 4 5 5 5 5 5 4 0 0 0 0 0 0 0 -1
0 0 0 0 0 0 0 4 0 0 0 0 0 4 0 0 0 0 0 0 0 -1
0 0 0 0 0 0 0 4 0 0 0 0 0 4 0 0 0 0 0 0 0 -1
0 0 0 0 0 0 0 4 0 0 0 0 0 4 0 0 0 0 0 0 0 -1
0 0 0 0 0 0 0 4 0 0 0 0 0 4 0 0 0 0 0 0 0 -1
0 0 0 0 0 0 0 4 0 0 0 0 0 4 0 0 0 0 0 0 0 -1
0 0 0 0 0 0 0 4 0 0 0 0 0 4 0 0 0 0 0 0 0 -1
0 0 0 0 0 0 0 4 0 0 0 0 0 4 0 0 0 0 0 0 0 -1
0 0 0 0 0 0 0 4 0 0 0 0 0 4 0 0 0 0 0 0 0 -1
0 0 0 0 0 0 0 4 0 0 0 0 0 4 0 0 0 0 0 0 0 -1
0 0 0 0 0 0 0 4 5 5 5 5 5 4 0 0 0 0 0 0 0 -1
0 0 0 0 0 0 0 0 0 0 0 0 0 0 0 0 0 0 0 0 0 -1
0 0 0 0 0 0 0 0 0 0 0 0 0 0 0 0 0 0 0 0 0 -1
0 0 0 0 0 0 0 0 0 0 0 0 0 0 0 0 0 0 0 0 0 -1
0 0 0 0 0 0 0 0 0 0 0 0 0 0 0 0 0 0 0 0 0 -1
0 0 0 0 0 0 0 0 0 0 0 0 0 0 0 0 0 0 0 0 0
-2
0 0 0 0 0 0 0 0 0 0 0 0 0 0 0 0 0 0 0 0 0 -1
0 0 0 0 0 0 0 0 0 0 0 0 0 0 0 0 0 0 0 0 0 -1
0 0 0 0 0 0 0 0 0 0 0 0 0 0 0 0 0 0 0 0 0 -1
0 0 0 0 0 0 0 0 0 0 0 0 0 0 0 0 0 0 0 0 0 -1
0 0 0 0 0 0 0 0 0 0 0 0 0 0 0 0 0 0 0 0 0 -1
0 0 0 0 0 0 0 0 4 5 5 5 4 0 0 0 0 0 0 0 0 -1
0 0 0 0 0 0 0 0 4 0 0 0 4 0 0 0 0 0 0 0 0 -1
0 0 0 0 0 0 0 0 4 0 0 0 4 0 0 0 0 0 0 0 0 -1
0 0 0 0 0 0 0 0 4 0 0 0 4 0 0 0 0 0 0 0 0 -1
0 0 0 0 0 0 0 0 4 0 0 0 4 0 0 0 0 0 0 0 0 -1
0 0 0 0 0 0 0 0 4 0 0 0 4 0 0 0 0 0 0 0 0 -1
0 0 0 0 0 0 0 0 4 0 0 0 4 0 0 0 0 0 0 0 0 -1
0 0 0 0 0 0 0 0 4 0 0 0 4 0 0 0 0 0 0 0 0 -1
0 0 0 0 0 0 0 0 4 0 0 0 4 0 0 0 0 0 0 0 0 -1
0 0 0 0 0 0 0 0 4 0 0 0 4 0 0 0 0 0 0 0 0 -1
0 0 0 0 0 0 0 0 4 5 5 5 4 0 0 0 0 0 0 0 0 -1
0 0 0 0 0 0 0 0 0 0 0 0 0 0 0 0 0 0 0 0 0 -1
0 0 0 0 0 0 0 0 0 0 0 0 0 0 0 0 0 0 0 0 0 -1
0 0 0 0 0 0 0 0 0 0 0 0 0 0 0 0 0 0 0 0 0 -1
0 0 0 0 0 0 0 0 0 0 0 0 0 0 0 0 0 0 0 0 0 -1
0 0 0 0 0 0 0 0 0 0 0 0 0 0 0 0 0 0 0 0 0
-2
0 0 0 0 0 0 0 0 0 0 0 0 0 0 0 0 0 0 0 0 0 -1
0 0 0 0 0 0 0 0 0 0 0 0 0 0 0 0 0 0 0 0 0 -1
0 0 0 0 0 0 0 0 0 0 0 0 0 0 0 0 0 0 0 0 0 -1
0 0 0 0 0 0 0 0 0 0 0 0 0 0 0 0 0 0 0 0 0 -1
0 0 0 0 0 0 0 0 0 0 0 0 0 0 0 0 0 0 0 0 0 -1
0 0 0 0 0 0 0 0 0 4 5 4 0 0 0 0 0 0 0 0 0 -1
0 0 0 0 0 0 0 0 0 4 0 4 0 0 0 0 0 0 0 0 0 -1
0 0 0 0 0 0 0 0 0 4 0 4 0 0 0 0 0 0 0 0 0 -1
0 0 0 0 0 0 0 0 0 4 0 4 0 0 0 0 0 0 0 0 0 -1
0 0 0 0 0 0 0 0 0 4 0 4 0 0 0 0 0 0 0 0 0 -1
0 0 0 0 0 0 0 0 0 4 0 4 0 0 0 0 0 0 0 0 0 -1
0 0 0 0 0 0 0 0 0 4 0 4 0 0 0 0 0 0 0 0 0 -1
0 0 0 0 0 0 0 0 0 4 0 4 0 0 0 0 0 0 0 0 0 -1
0 0 0 0 0 0 0 0 0 4 0 4 0 0 0 0 0 0 0 0 0 -1
0 0 0 0 0 0 0 0 0 4 0 4 0 0 0 0 0 0 0 0 0 -1
0 0 0 0 0 0 0 0 0 4 5 4 0 0 0 0 0 0 0 0 0 -1
0 0 0 0 0 0 0 0 0 0 0 0 0 0 0 0 0 0 0 0 0 -1
0 0 0 0 0 0 0 0 0 0 0 0 0 0 0 0 0 0 0 0 0 -1
0 0 0 0 0 0 0 0 0 0 0 0 0 0 0 0 0 0 0 0 0 -1
0 0 0 0 0 0 0 0 0 0 0 0 0 0 0 0 0 0 0 0 0 -1
0 0 0 0 0 0 0 0 0 0 0 0 0 0 0 0 0 0 0 0 0
-2
0 0 0 0 0 0 0 0 0 0 0 0 0 0 0 0 0 0 0 0 0 -1
0 0 0 0 0 0 0 0 0 0 0 0 0 0 0 0 0 0 0 0 0 -1
0 0 0 0 0 0 0 0 0 0 0 0 0 0 0 0 0 0 0 0 0 -1
0 0 0 0 0 0 0 0 0 0 0 0 0 0 0 0 0 0 0 0 0 -1
0 0 0 0 0 0 0 0 0 0 0 0 0 0 0 0 0 0 0 0 0 -1
0 0 0 0 0 0 0 0 0 0 4 0 0 0 0 0 0 0 0 0 0 -1
0 0 0 0 0 0 0 0 0 0 4 0 0 0 0 0 0 0 0 0 0 -1
0 0 0 0 0 0 0 0 0 0 4 0 0 0 0 0 0 0 0 0 0 -1
0 0 0 0 0 0 0 0 0 0 4 0 0 0 0 0 0 0 0 0 0 -1
0 0 0 0 0 0 0 0 0 0 4 0 0 0 0 0 0 0 0 0 0 -1
0 0 0 0 0 0 0 0 0 0 4 0 0 0 0 0 0 0 0 0 0 -1
0 0 0 0 0 0 0 0 0 0 4 0 0 0 0 0 0 0 0 0 0 -1
0 0 0 0 0 0 0 0 0 0 4 0 0 0 0 0 0 0 0 0 0 -1
0 0 0 0 0 0 0 0 0 0 4 0 0 0 0 0 0 0 0 0 0 -1
0 0 0 0 0 0 0 0 0 0 4 0 0 0 0 0 0 0 0 0 0 -1
0 0 0 0 0 0 0 0 0 0 4 0 0 0 0 0 0 0 0 0 0 -1
0 0 0 0 0 0 0 0 0 0 0 0 0 0 0 0 0 0 0 0 0 -1
0 0 0 0 0 0 0 0 0 0 0 0 0 0 0 0 0 0 0 0 0 -1
0 0 0 0 0 0 0 0 0 0 0 0 0 0 0 0 0 0 0 0 0 -1
0 0 0 0 0 0 0 0 0 0 0 0 0 0 0 0 0 0 0 0 0 -1
0 0 0 0 0 0 0 0 0 0 0 0 0 0 0 0 0 0 0 0 0
-2